########################################
#A   #       #       #     #     #    #
# ### ##### ### ### ### ### ### # #####
#   #     #   #   #   #   #   # #     #
### ### # ### ### # ### ##### # ##### #
#     # # #   #   #     #   #       # #
# ### # # # ### ######### ### ##### # #
#   #   #   #         #           #   #
### ### ##### ##### # # ##### # ##### #
#   # #   #     #   # # #   # #       #
# # # ### ### ### ### ### # # #### ###
# #   #     #     #   #   # #       # #
# ####### ### ### ### # ### #####   # #
#   #       #   #   # #     #   #   # #
### ##### # ### # # # ####### ### # ###
#   #   # #   # # #   #       #   #   #
# ### # # ### # # # # # ####### #######
# #   #   #   #   # # # #     #       #
# ### ### # ### ### ### # ### ####### #
#   #   #   # #     #   #   #       # #
##### ### ### ##### ## ## ######### # #
#       #   #   #   #     #       #   #
# ####### ##### # ### ### # ####### ###
#   #     #     #   #   # #   #       #
# ### ##### ##### ### # ### ### ##### #
# #   #     #   #   # #     #       # #
### ### ##### ##### ####### ####### # #
#     #     #   #   #   #       #   # #
# ### ####### ### ### # ### ##### # ###
#   #       #       #           # #   #
##### ##### ## ## ### ###   ### ##### #
#     #   #     #       #           #B#
########################################
